roll_num,stu_name,sub1,sub2,sub3,sub4,total_marks,average_marks,grade
1,s1,85,80,78,82,325,81.25,A
2,s2,78,82,81,79,320,80.0,A
3,s3,90,85,84,86,345,86.25,A
4,s4,88,87,86,89,350,87.5,A
5,s5,76,78,80,77,311,77.75,B
6,s6,95,91,93,92,371,92.75,A+
7,s7,89,88,87,90,354,88.5,A
8,s8,84,86,85,83,338,84.5,A
9,s9,92,90,89,88,359,89.75,A
10,s10,75,77,79,76,307,76.75,B
